WWWWWWWWWWWWWWWWWWWW
W000000000000000000W
W0WcWWWWW0000000000W
W0WcccccW0000000000W
W0WWWWWcWWWW0000000W
W00000Wccccc0000000W
W0wWWWWcWWWW0000000W
0000000000000000000W
W000000000000000000W
W000000000000000000W
W000000000000000000W
W000000000000000000W
W000000000000000000W
W000000000000000000W
WWWWWWWWWWWWWWWWWWWW