0011111111100
001C00C00C100
0010110110100
001C00P00C100
0010110110100
001C00C00C100
0011111111100